1 15 25
02 02 02 02 02 02 02 02 02 02 02 02 02 02 02 02 02 02 02 02 02 02 02 02 02
02 00 00 00 03 00 00 00 00 12 03 00 00 00 03 00 00 00 03 00 00 00 00 00 02
02 00 02 03 02 03 02 00 02 03 02 03 02 00 02 00 00 00 02 00 02 03 02 03 02
02 00 03 00 00 00 03 00 03 00 00 00 03 00 03 03 00 00 03 00 03 00 00 00 02
02 00 02 00 08 00 02 00 02 00 14 00 02 00 02 03 02 00 02 00 02 00 00 00 02
02 00 03 00 00 00 03 00 03 00 00 00 03 00 03 00 03 00 03 00 03 00 00 00 02
02 00 02 00 00 03 02 00 02 00 00 00 02 00 02 00 02 00 02 00 02 08 00 00 02
02 00 00 03 03 00 00 00 03 00 00 00 03 00 03 00 03 00 03 00 00 00 00 00 02
02 00 02 00 00 03 02 00 02 00 00 12 02 00 02 00 02 00 02 00 02 03 02 03 02
02 00 03 00 13 00 03 00 00 00 00 00 03 00 00 00 03 00 00 00 03 00 00 00 02
02 00 02 00 00 00 02 00 02 00 08 00 02 00 02 00 02 03 02 00 02 00 00 00 02
02 00 03 00 00 00 03 00 03 00 00 00 03 00 03 00 00 03 03 00 03 00 00 00 02
02 00 02 03 02 03 02 00 02 03 02 03 02 00 02 00 00 00 02 00 02 03 02 03 02
02 00 00 00 03 00 00 00 15 00 03 00 00 00 03 00 00 00 03 00 00 00 00 00 02
02 02 02 02 02 02 02 02 02 02 02 02 02 02 02 02 02 02 02 02 02 02 02 02 02