1 15 25
02 02 02 02 02 02 02 02 02 02 02 02 02 02 02 02 02 02 02 02 02 02 02 02 02
02 00 00 00 03 00 00 00 00 12 03 00 00 00 03 00 00 00 03 00 00 00 00 00 02
02 00 02 00 03 00 02 00 02 03 02 03 02 03 02 00 00 00 02 00 02 03 02 03 02
02 00 03 00 00 00 03 00 03 00 00 00 03 00 00 03 00 00 08 00 03 00 00 00 02
02 00 02 00 08 00 02 00 02 00 12 00 02 00 02 03 02 00 02 00 02 00 00 00 02
02 00 03 00 00 00 03 00 03 00 00 00 03 00 03 00 03 00 03 00 02 00 02 00 02
02 00 02 00 00 03 02 00 02 00 00 00 02 00 02 00 02 00 02 00 02 08 00 00 02
02 00 00 03 02 03 00 00 02 03 03 00 07 00 03 00 03 00 03 00 00 00 00 00 02
02 00 02 00 00 03 02 00 02 00 00 12 02 00 02 00 02 00 02 00 02 03 02 03 02
02 00 03 00 10 00 03 00 00 00 00 00 03 00 00 00 03 00 00 00 03 00 00 00 02
02 00 02 00 00 02 00 00 02 00 08 00 02 00 02 00 02 03 02 00 02 00 00 00 02
02 00 03 00 00 00 03 00 03 00 00 00 03 00 03 00 00 03 03 00 03 00 00 00 02
02 00 02 06 02 00 07 00 02 03 02 03 02 00 02 00 00 00 02 00 02 03 02 03 02
02 00 00 00 03 00 00 00 11 00 03 00 00 00 03 00 00 00 03 00 00 00 00 00 02
02 02 02 02 02 02 02 02 02 02 02 02 02 02 02 02 02 02 02 02 02 02 02 02 02