3 15 25
02 02 02 02 02 02 02 02 02 02 02 02 02 02 02 02 02 02 02 02 02 02 02 02 02
02 00 00 00 00 00 00 00 00 11 00 00 00 00 00 00 00 00 00 00 08 00 00 00 02
02 00 02 00 00 00 02 00 02 00 02 00 02 06 02 03 02 00 02 03 02 07 02 00 02
02 00 03 03 03 03 03 03 03 03 03 00 00 00 03 03 03 03 03 03 03 00 00 00 02
02 00 02 03 02 00 02 00 02 00 02 00 02 00 02 00 02 03 02 00 02 00 02 00 02
02 00 00 03 00 00 00 14 00 00 00 00 00 00 00 14 00 03 00 00 00 00 00 00 02
02 09 02 03 02 00 02 00 02 00 02 00 02 00 02 00 02 03 02 00 02 09 02 00 02
02 00 00 00 03 03 03 03 03 03 00 00 00 11 00 00 00 00 00 00 00 00 00 00 02
02 00 02 00 02 00 02 03 06 00 02 00 02 00 02 00 02 03 02 00 02 00 02 00 02
02 00 00 00 00 13 00 00 02 00 00 00 00 00 00 00 00 03 00 00 00 00 00 09 02
02 00 02 00 02 00 02 03 02 03 02 00 02 00 02 00 02 03 02 00 02 00 02 00 02
02 00 03 03 03 03 03 03 03 03 03 00 00 00 00 00 00 00 00 00 00 00 00 00 02
02 00 02 06 02 00 02 00 02 00 02 00 02 00 02 00 02 07 02 00 02 00 02 00 02
02 00 00 00 00 00 00 00 00 00 15 00 00 08 00 00 00 00 00 00 00 00 00 00 02
02 02 02 02 02 02 02 02 02 02 02 02 02 02 02 02 02 02 02 02 02 02 02 02 02